1	1	1	1	1	1	1	1	1	1	1	1	1	1	1	1	1	1	1
1	4	4	4	5	5	5	5	5	5	5	5	5	5	5	4	4	4	1
1	4	3	3	3	3	3	3	3	3	3	3	3	3	3	3	3	4	1
1	4	3	4	5	5	5	5	5	3	5	5	5	3	5	4	3	4	1
1	4	3	4	0	0	0	0	0	3	0	0	0	3	0	4	3	4	1
1	4	3	4	1	1	1	1	1	2	1	1	1	2	1	4	3	4	1
1	4	3	4	1	2	2	2	1	2	1	2	2	2	1	4	3	4	1
1	4	3	4	1	2	2	2	1	2	1	2	2	2	1	4	3	4	1
1	4	3	4	1	2	1	1	1	2	1	1	1	1	1	4	3	4	1
1	4	3	4	1	2	2	2	2	2	2	2	2	2	1	4	3	4	1
1	4	3	4	1	1	1	1	1	2	1	1	1	2	1	4	3	4	1
1	5	3	5	3	3	3	5	1	2	1	2	2	2	1	5	3	5	1
1	5	3	5	3	3	3	5	1	2	2	2	2	2	1	5	3	5	1
1	0	3	3	3	3	3	5	1	2	1	1	1	2	1	5	3	5	1
1	0	3	4	5	5	5	5	1	2	1	2	2	2	1	5	3	5	1
1	0	3	1	1	1	1	1	1	2	1	1	1	2	1	5	3	5	1
1	0	3	2	2	2	1	2	2	2	2	2	1	2	1	4	0	4	1
1	0	0	1	2	2	1	2	1	2	2	2	1	2	1	4	4	4	1
1	1	1	1	1	1	1	1	1	1	1	1	1	1	1	1	1	1	1
