1	1	1	1	1	1	1	1	1	1	1	1	1	1	1	1	1	1	1
1	0	0	0	4	0	4	3	4	3	0	0	4	0	0	0	5	0	1
1	0	4	0	5	0	4	3	3	3	4	5	4	4	4	4	4	0	1
1	5	4	0	4	0	4	4	4	4	4	0	4	0	4	0	4	0	1
1	0	4	0	4	0	0	0	0	0	0	0	4	0	4	0	4	0	1
1	0	4	4	4	4	4	4	4	0	4	0	4	0	4	5	0	0	1
1	0	0	0	0	0	4	0	4	4	4	0	0	0	4	0	4	4	1
1	0	4	0	4	0	4	0	4	3	3	3	4	0	4	0	4	0	1
1	5	4	0	4	4	4	0	4	3	4	4	4	0	4	0	0	0	1
1	0	4	0	0	0	0	0	4	3	4	0	0	5	4	0	4	0	1
1	0	4	4	5	4	4	4	4	3	4	4	4	0	0	0	4	0	1
1	4	4	0	0	0	4	0	4	4	4	0	0	0	4	0	4	4	1
1	5	0	0	4	0	4	0	0	5	0	0	4	4	4	0	4	0	1
1	0	4	4	4	0	0	0	4	4	4	0	0	0	4	5	0	0	1
1	0	4	0	4	0	4	3	4	3	4	0	4	0	4	4	4	0	1
1	5	0	0	4	0	4	3	3	3	4	5	4	0	0	0	4	0	1
1	0	4	0	4	0	4	4	3	4	4	0	4	4	4	4	4	5	1
1	0	4	0	0	0	0	4	3	4	0	0	0	0	0	4	4	0	1
1	1	1	1	1	1	1	1	1	1	1	1	1	1	1	1	1	1	1
