0	0	0	0	0	0	0	0	0	0	0	0	0	0	0	0	0	0	0
0	0	7	0	0	1	1	0	1	1	0	8	8	0	0	0	0	0	0
0	1	0	7	3	0	0	0	0	0	0	8	0	0	0	8	0	2	0
0	7	0	7	0	0	0	0	8	0	3	0	0	3	0	8	0	2	0
0	7	0	7	0	2	2	0	8	0	0	0	1	0	0	8	7	7	0
0	0	3	0	0	0	0	0	0	3	0	0	0	0	1	0	7	7	0
0	2	1	2	0	7	7	0	1	0	0	8	1	0	1	0	7	7	0
0	0	0	0	0	0	0	0	0	0	0	8	0	0	0	3	0	0	0
0	0	0	3	0	0	3	0	0	0	0	0	3	0	0	0	7	7	0
0	1	0	0	0	0	0	0	0	0	0	0	0	0	1	0	7	7	0
0	0	0	0	0	0	0	0	0	5	0	0	0	0	1	0	7	7	0
0	1	2	0	0	2	0	7	7	0	3	0	0	0	0	0	7	7	0
0	0	0	0	0	0	0	7	7	0	0	3	0	3	0	0	7	7	0
0	0	0	0	0	0	3	0	1	0	0	0	1	0	0	3	0	0	0
0	0	0	0	0	0	0	0	0	3	0	0	0	0	2	2	7	7	0
0	0	0	0	0	0	0	2	2	0	1	0	0	0	0	3	0	0	0
0	8	8	0	1	0	0	2	2	0	0	8	8	0	8	8	7	7	0
0	8	8	7	7	7	0	0	0	0	0	8	8	0	8	8	7	7	0
0	0	0	0	0	0	0	0	0	0	0	0	0	0	0	0	0	0	0
