1	1	1	1	1	1	1	1	1	1	1	1	1	1	1	1	1	1	1
1	2	2	2	1	2	2	1	2	2	1	2	2	1	5	5	5	5	1
1	2	2	2	2	2	2	1	2	2	1	2	2	1	0	0	0	0	1
1	2	2	2	1	2	2	1	2	2	2	2	2	2	0	0	0	0	1
1	2	2	2	1	2	2	1	2	2	1	2	2	1	5	0	0	0	1
1	1	2	1	1	1	1	1	1	2	1	1	1	1	0	0	0	0	1
1	2	2	2	1	2	2	1	2	2	1	2	2	1	0	0	0	0	1
1	2	2	2	1	2	2	1	2	2	1	2	2	1	1	0	1	1	1
1	1	1	2	1	1	2	1	2	2	1	1	2	1	5	0	0	0	1
1	2	2	2	2	2	2	2	2	2	2	2	2	1	0	0	0	0	1
1	1	1	1	1	1	1	1	1	2	2	1	1	1	0	0	0	0	1
1	2	2	2	2	2	1	2	2	1	2	1	2	1	5	0	0	0	1
1	6	6	6	6	2	1	2	2	2	2	2	2	2	0	0	0	0	1
1	6	6	6	6	2	2	2	2	2	2	1	2	1	1	0	1	1	1
1	6	6	6	6	2	1	1	1	2	1	1	1	1	0	0	0	0	1
1	2	2	2	2	2	1	2	2	2	2	2	2	1	1	0	1	1	1
1	2	2	2	2	2	1	2	2	2	2	2	2	1	0	0	0	0	1
1	2	2	2	2	2	1	2	2	2	2	2	2	1	0	0	0	0	1
1	1	1	1	1	1	1	1	1	1	1	1	1	1	1	1	1	1	1
