1	1	1	1	1	1	1	1	1	1	1	1	1	1	1	1	1	1	1
1	5	5	5	5	5	5	5	5	5	5	5	5	5	5	5	5	5	1
1	5	3	3	3	3	3	3	3	3	3	3	3	3	3	3	3	5	1
1	5	3	0	0	0	0	0	0	0	0	0	0	0	0	0	3	5	1
1	5	3	0	1	0	1	0	1	1	1	0	1	0	1	0	3	5	1
1	5	3	0	1	1	1	0	1	2	1	0	1	0	1	0	3	5	1
1	5	3	0	0	1	0	0	1	2	1	0	1	0	1	0	3	5	1
1	5	3	0	0	1	0	0	1	1	1	0	1	1	1	0	3	5	1
1	5	3	4	4	4	4	4	4	3	4	4	4	4	4	4	3	5	1
1	5	3	3	3	3	3	3	3	3	3	3	3	3	3	3	3	5	1
1	5	1	0	1	0	1	0	1	1	1	0	1	0	0	1	3	4	1
1	5	1	0	1	0	1	0	1	2	1	0	1	1	0	1	3	4	1
1	5	1	1	0	1	1	0	1	2	1	0	1	0	1	1	3	5	1
1	5	1	0	0	0	1	0	1	1	1	0	1	0	0	1	3	4	1
1	5	4	4	4	4	4	4	4	4	4	4	4	4	4	4	3	5	1
1	5	3	3	3	3	3	3	3	3	3	3	3	3	3	3	3	5	1
1	5	5	5	5	5	5	5	5	3	5	5	5	5	5	5	5	5	1
1	0	0	0	0	0	0	0	0	0	0	0	0	0	0	0	0	0	1
1	1	1	1	1	1	1	1	1	1	1	1	1	1	1	1	1	1	1
